円さ|まるさ
ほら貝
正しさ|ただしさ
大正|たいしょう
青さ|あおさ
日本|にほん
一月目|ひとつきめ
四月目|よつきめ
六月目|むつきめ
七月目|ななつきめ
五日|いつか
六日|むいか
八日|ようか
九日|ここのか
十日|とおか
白羽の矢|しらはのや
学びの園|まなびのその
当園|とうえん
北遠|ほくえん
何点|なんてん
何年|なんねん
何台|なんだい
その外|そのほか
楽しげだ|たのしげあ
丸さ|まるさ
中京|ちゅうきょう
京王|けいおう
午ぜん|ごぜん
米国|べいこく
国市|くにいち
黒さ|くろさ
細かだ|こまかだ
姉上|あねうえ
食店|しょくてん
新しさ|あたらしさ
新しがる|あたらしがる
新ただ|あらただ
親しさ|したしさ
数年|すうねん
数日|すうじつ
数人|すうにん
数分|すうふん
数名|すうめい
話数|わすう
大音声|だいおんせい
晴れやかだ|はれやかだ
一台|いちだい
何台|なんだい
売地|うりち
長さ|ながさ
通りゃんせ|とおりゃんせ
食店|しょくてん
中東|ちゅうとう
同じだ|おなじだ
三十分|さんじゅっぷん
北米|ほくべい
妹たち|いもうとたち
明るさ|あかるさ
明らかだ|あきらかだ
明くる朝|あくるあさ
夜が明ける|よがあける
安らかだ|やすらかだ
氷屋|こおりや
温かだ|あたたかだ
寒がる|さむがる
宮様|みやさま
北区|きたく
西区|にしく
南区|みなみく
東区|ひがしく
苦しがる|くるしがる
神具|しんぐ
母君|ははぎみ
手軽だ|てがるだ
軽やかだ|かろやかだ
記号|きごう
次走|じそう
六大州|ろくだいしゅう
本州|ほんしゅう
拾万円|いちまんえん
何重|なんじゅう
重音|じゅうおん
暑さ|あつさ
昭和|しょうわ
全農|ぜんのう
速やかだ|すみやかだ
第二|だいに
第三|だいさん
第四|だいよん
第五|だいご
第九|だいきゅう
着後|ちゃくご
二丁目|にちょうめ
定かだ|さだかだ
二倍|にばい
何倍|なんばい
数倍|すうばい
箱根|はこね
悲しがる|かなしがる
美しさ|うつくさ
数秒|すうびょう
本品|ほんぴん
川の面|かわのつら
星様|ほしさま
夏旅|なつたび
字路|じろ
和やかだ|なごやかだ
昭和|しょうわ
作業衣|さぎょうい
第一位|だいいちい
何位|なんい
英国|えいこく
栄えある|さかえある
一億|いちおく
各園|かくえん
関東|かんとう
関西|かんさい
挙げて|あげて
群すずめ|むらすずめ
二階建て|にかいだて
一戸建ち|いっこだち
健やかだ|おだやかだ
験がある|げんがある
固さ|かたさ
好きな絵|すきなえ
香港|ほんこん
参万円|さんまんえん
散り散りに|ちりじりに
明治|めいじ
信州|しんしゅう
平成|へいせい
清らかだ|きよらかだ
静かだ|しずかだ
方達|かたがた
男達|おとこたち
者達|ものたち
子達|こたち
低さ|ひくさ
阪神|はんしん
阪急|はんきゅう
駅別|えきべつ
題別|だいべつ
その辺|そのへん
名前変え|なまえがえ
約半分|やくはんぶん
要心深い|ようじんぶかい
北陸|ほくりく
歯類|しるい
冷たさ|つめたさ
冷ややかだ|ひややかだ
国連|こくれん
易しさ|やさしさ
仮の住まい|かりのすまい
確かだ|たしかだ
確かさ|たしかさ
前額部|ぜんがくぶ
お経|おきょう
何件|なんけん
険しさ|けわしさ
構わない|かまわない
在りし日|ありしひ
富士|ふじ
配設|はいせつ
築浅|ちくあさ
これ程|これほど
写真版|しゃしんばん
非の打ち所|ひのうちどころ
貧しさ|まずしさ
武者人形|むしゃにんぎょう
仏様|ほとけさま
豊かだ|ゆたかだ
歴然たる|れきぜんたる
異にする|いにする
割がいい|わりがいい
五割|ごわり
何割|なんわり
巻の一|まきのいち
危ながる|あぶながる
貴院|きいん
激しさ|はげしさ
厳かだ|おごそかだ
使用済み|しようずみ
何冊|なんさつ
私共|わたくしども
一寸先|いっすんさき
盛んだ|さかんだ
盛んに|さかんに
何層|なんそう
操り人形|あやつりにんぎょう
存じます|ぞんじます
暖かだ|あたたかだ
著しさ|いちじるしさ
痛さ|いたさ
許し難い|ゆるしがたい
否めない|いなめない
一俵|いっぴょう
並の品|なみのしな
欲しがる|ほしがる
朗らかだ|ほがらかだ
朗らかさ|ほがらかさ
偉ぶる|えらぶる
壱万円|いちまんえん
隠然たる|いんぜんたる
書影|しょえい
上越|じょうえつ
越中|えっちゅう
暇な時|ひまなとき
皆出席|かいしゅっせき
漁獲高|ぎょかくだか
幾人|いくにん
机の脚|つくえのあし
御心|おこころ
何軒|なんけん
聖剣|せいけん
倉庫荒らし|そうこあらし
香港|ほんこん
惨めだ|みじめだ
業を煮やす|ごうをにやす
寂として|せきとして
寂しがる|さびしがる
ぶどう狩り|ぶどうがり
柔らかだ|やわらかだ
最旬|さいしゅん
国会の召集|こっかいのめいしゅう
詳しさ|くわしさ
丈夫な体|じょうぶなからだ
愛想を尽かす|あいそをつかす
鮮やかだ|あざやかだ
珍しさ|めずらしさ
珍しがる|めずらしがる
添え手紙|そえてがみ
無添|むてん
佐渡|さど
唐草模様|からくさもよう
桃源境|とうげんきょう
高踏的|こうとうてき
一突き|ひとつき
弐万円|にまんえん
濃さ|こさ
数匹|すうひき
忙しさ|いそがしさ
漫然と|まんぜんと
麗しさ|うるわしさ
高麗|こうらい
恋しがる|こいしがる
哀れな話|あわれなはなし
西欧|せいおう
欧州|おうしゅう
北欧|ほくおう
南欧|なんおう
穏やかだ|おだやかだ
華やかだ|はなやかだ
怪しげだ|あやしげだ
悔しがる|くやしがる
滑らかだ|なめらかだ
緩やかだ|ゆるやかだ
脅し文句|おどしもんく
愚かだ|おろかだ
硬さ|かたさ
巧みな術|たくみなじゅつ
慌ただしさ|あわただしさ
慌ただしげだ|あわただしげあ
文殊|もんじゅ
出穂期|しゅっすいき
数隻|すうせき
双月|そうげつ
憎さ|にくさ
鍛え方|鍛え方
産婆役|さんばやく
卑しさ|いやしさ
素封家|そほうか
芳しさ|かんばしさ
乏しさ|とぼしさ
首謀者|しゅぼうさ
一房|ひとふさ
台湾|たいわん
妹兄|いもせ
兄妹|きょうだい
弟妹|ていまい
一つ|ひとつ
一わ|いちわ
一円玉|いちえんだま
一ぴき|いっぴき
一ぽん|いっぽん
一月|いちがつ
二つ|ふたつ
二わ|にわ
二円|にえん
二ひき|にひき
二ほん|にほん
二月|にがつ
三つ|みっつ
三わ|さんわ
三円|さんえん
三びき|さんびき
三ぼん|さんぼん
三月|さんがつ
四つ|よっつ
四わ|よんわ
四円|よえん
四ひき|よんひき
四ほん|よんほん
四月|しがつ
五つ|いつつ
五わ|ごわ
五円玉|ごえんだま
五ひき|ごひき
五ほん|ごほん
五月|ごがつ
六つ|むっつ
六わ|ろくわ
六円|ろくえん
六ぴき|ろっぴき
六ぽん|ろっぽん
六月|ろくがつ
七つ|ななつ
七わ|ななわ
七円|ななえん
七ひき|ななひき
七ほん|ななほん
七月|しちがつ
八つ|やっつ
八わ|はちわ
八円|はちえん
八ぴき|はっぴき
八ほん|はちほん
八月|はちがつ
九つ|ここのつ
九わ|きゅうわ
九円|きゅうえん
九ひき|きゅうひき
九ほん|きゅうほん
九月|くがつ
十こ|じゅっこ
十わ|じゅうわ
十円玉|じゅうえんだま
十ぴき|じゅっぴき
十本|じゅっぽん
足音|あしおと
雨音|あまおと
かざ音|かざおと
音いろ|ねいろ
本音|ほんね
よわ音|よわね
足音|あしおと
子音|しいん
ぼ音|ぼいん
よ音|よいん
山村|やまむら,さんそん
入村|にゅうそん
村ざと|むらざと
青田|あおた
火田|かでん
田えん|でんえん
田うえ|たうえ
えっ冬|とう
冬き|とうき
冬がれ|ふゆがれ
冬じ|とうじ
